40,50
0000000000000000000000000000000000000000
0000000000000000000000000000000000000000
0000000000000000000000000000000000000000
0000000000000000000000000000000000000000
0000000000000000000000000000000000000000
0000000000000000000000000000000000000000
0000000446600646644666666000000000000000
0000000644444444111111144000000000000000
0000004466444444188888144666600000000000
0000000044444444188888144446666000000000
0000000044444444188888144444444660000000
0000000004444455555554444444444466000000
0000000044444444455554444444444440000000
0000000044444444475554444444444460000000
0000000000444444444544444444884460000000
0000000000004444444555555555884440000000
0000000000004444444544444444884400000000
0000000000000444444544444444774400000000
0000000000000000000900000044666000000000
0000000000000000004544000000000000000000
0000000000000000644544466000000000000000
0000000000000066444544444400000000000000
0000000000000664441514444400000000000000
0000000000000064441514446000000000000000
0000000000000000441114466000000000000000
0000000000000000000000000000000000000000
0000000000000000000000000000000000000000
0000000000000000000000000000000000000000
0000000000000000000000000000000000000000
0000000000000000000000000000000000000000
0000000000000000000000000000000000000000
3333333333333333333333333333333333333333
3333333333333333333333333333333333333333
3333333333333333333333333333333333333333
3333333333333333333333333333333333333333
3333333333333333333333333333333333333333
3333333333333333333333333333333333333333
3333333333333333333333311111111111333333
3333333333333333333333318888888881333333
3333333333333333333333318888888881333333
3333333333333333333333318888888881333333
3333333333333333333333318888888881333333
3333333333333333333333318888888881333333
3333333333333333333333311111111111333333
3333333333333333333333333333333333333333
3333333333333333333333333333333333333333
3333333333333333333333333333333333333333
3333333333333333333333333333333333333333
3333333333333333333333333333333333333333
3333333333333333333333333333333333333333
